####################
@000000000000000000#
##################0#
#########0000000000#
########00##########
######000###########
#000000#############
#0######00000000000#
#0######X#########0#
#0################0#
#000000000000000000#
####################