####################
@000000000000000000#
##################0#
#0000000000000000#0#
#0##############0#0#
#0#000000000000#0#0#
#0#0##########0#0#0#
#0#0##########0#0#0#
#0#0##000000##0#0#0#
#0#0##0####0##0#0#0#
#0#0##0#X0#0##0#0#0#
#0#0##0##000##0#0#0#
#0#0##0#######0#0#0#
#0#0##0#######0#0#0#
#0#0##000000000#0#0#
#0#0############0#0#
#0#00000000000000#0#
#0################0#
#000000000000000000#
####################
